50 50 50 50 50 50 50 50 50 50
50 52 51 51 51 51 51 51 53 50
50 11 11 11 11 11 11 11 11 50
50 13 12 12 12 12 12 12 14 50
50 54 54 54 54 54 54 54 15 50
50 16 16 16 16 16 16 56 15 50
50 16 16 16 16 16 16 56 15 50
50 13 12 12 12 12 12 12 14 50
50 11 11 11 11 11 11 11 11 50
50 50 50 50 50 50 50 50 50 50